########### #########
#   #         #     #
# ### ##### # # #####
#   # #     #   #   #
# # # # # ####### # #
# #   # # #   #   # #
# ##### # # # # ### #
# #     # # # #   # #
# # ####### # # ### #
# #         # # #   #
######### ### # # # #
#   #   #   #   # # #
### # # ######### # #
# #   #     #     # #
# ######### # ##### #
#     #     # #     #
### # # ##### # #####
#   # # #   # # #   #
# ##### # # # # ### #
#         #   #     #
########### #########