############### ###############
#       #           #         #
##### # # ##### ##### # ##### #
#   # #   #   # #     # # #   #
# # ##### ### # # ##### # # ###
# #     #     #   #   # #   # #
# ##### # ##### ### # # # ### #
# #   # # #   # #   #   # #   #
# ### # ### # ### ####### # # #
#   #       # #   #     # # # #
### # ####### # ### # ### ### #
#   # #     # # # # #     #   #
# # ### ### # # # # ####### # #
# # #   #   #   #   #     # # #
# ### ### ####### ##### # # ###
# #   # # #       #     #   # #
# # ### # ### ##### ##### ### #
# # #   #   #     #   #   #   #
# # ### ### ##### ### ### # ###
# #   #   #   #     #   # #   #
# ### # # ### ##### ### ##### #
#   # # #   #   #   #   #     #
# # # # # ##### # ### # # #####
# # # # # #     # #   # # #   #
### # # # # ##### # ##### # ###
#   # # # # #       #   # #   #
# ### # # # # ####### # # ### #
#     # # # # #   #   # # #   #
# ####### # ### # # ### # # # #
#         #     #     #     # #
############### ###############