##### #####
#         #
# ##### # #
#     # # #
####### # #
#     # # #
##### # ###
# #   #   #
# # ##### #
#         #
##### #####